R 1200 800
C 135,206,235  
F 250,235,215
S  ./Textures/48.xpm
NO ./Textures/wood.xpm  
SO  ./Textures/colorstone.xpm
WE ./Textures/bluestone.xpm
EA  ./Textures/redbrick.xpm

1111111111111111111111111
100E000000110000000000001
1011000001110000002000001
10010000000000000000000011111111
111111111011000001110000000000001
100000000011000001110111111111111
11110111111111011100000010001
11110111111111011101010010001
11000000110101011100000010001
10002000000000001100000010001
10000000000000001101010010001
1100000111010101111101111000111
11110111 1110101 101111010001
11111111 1111111 111111111111
