
R 700 500
C 7,4   , 61    
F 0,128,0 
S  ./Textures/48.xpm
NO ./Textures/wood.xpm  
SO  ./Textures/liere.xpm
WE ./Textures/bluestone.xpm
EA  ./Textures/redbrick.xpm

      111
     12021
    1020001
    1000001
    100W001
    1200021
     12021
     10001
     12021
     10001                                1111111
 111112021111111111111111111           1110000000111
10000000000000000000000000001        11000000000000011
10020000000000000000000000111       1000000000000000001
10000000000000000000000000000111111100000000000000000001
 11110000000000001111110000000000000000000000000000000001
    1000000000001   1000000000000000000000000000000000001
    1000000000001    10000000011111110000000000000000001
    10000000000001111000000111      1000000000000000001
 111000000000000000000000001         11000000000000011
1000000000000000100000111111           1110000000111
1000000111110000000001                    1100001
1000001     100000001       111111111111111100001
1000001     100000001       100000000000000000001
 11111       1111111        111111111111111111111
